{
    "mapa_id": 2354051212032,
    "mapa_art": [
        "##################################################",
        "#................................................#",
        "#..#########.......################..###########.#",
        "#..# @     #.......#           B  #..#B   P   B#.#",
        "#..#       #.......#              #..# @       #.#",
        "#..#       #.......#              #..#@        #.#",
        "#..#####  ##.......###  ###########..#         #.#",
        "#......#  #..........#  #............#      @  #.#",
        "#......#  ############  #............#         #.#",
        "#......#              @ ##############         #.#",
        "#......#                                       #.#",
        "#......#                ########################.#",
        "#......#@               #W       B#..............#",
        "#..#####                #         #..............#",
        "#..# B                  #         #..............#",
        "#..#                    ####HH#####..............#",
        "#..# @                     @      #..............#",
        "#..#                @             #..............#",
        "#..#                        @     #..............#",
        "#..#                              #..............#",
        "#..#                              #..............#",
        "#..#                             ##..............#",
        "#..################################..............#",
        "#................................................#",
        "##################################################"
    ],
    "inimigos_derrotados": [],
    "baus_abertos": [],
    "interacoes": {},
    "obstaculos": [
        "#",
        ".",
        "H"
    ],
    "cores": null
}