{
    "mapa_id": 2264777612800,
    "mapa_art": [
        "##################################################",
        "#................................................#",
        "#..#########.......################..###########.#",
        "#..#       #.......#           B  #..#B   P   B#.#",
        "#..#       #.......#              #..#         #.#",
        "#..#       #.......#              #..#         #.#",
        "#..#####  ##.......###  ###########..#         #.#",
        "#......#  #..........#  #............#         #.#",
        "#......#  ############  #............#         #.#",
        "#......#                ##############         #.#",
        "#......#  @                                    #.#",
        "#......#                ########################.#",
        "#......#                #W       B#..............#",
        "#..#####                #         #..............#",
        "#..# B               @  #   @     #..............#",
        "#..#                    ####HH#####..............#",
        "#..#                              #..............#",
        "#..#         @       @            #..............#",
        "#..#     @             @          #..............#",
        "#..#                    @         #..............#",
        "#..#                              #..............#",
        "#..#  @              @           ##..............#",
        "#..################################..............#",
        "#................................................#",
        "##################################################"
    ],
    "inimigos_derrotados": [],
    "baus_abertos": [],
    "interacoes": {},
    "obstaculos": [
        "#",
        ".",
        "H"
    ],
    "cores": null
}