{
    "mapa_id": "castelo_2",
    "mapa_art": [
        "########################\u2592\u2592########################",
        "#....#W    #...........#  #......................#",
        "#....#     #...........#  #.....############.....#",
        "#....#     #...........#  #.....#B  @P     #.....#",
        "#....####  #...........#  #.....#          #.....#",
        "#.......#  #...........#  #.....#  @       #.....#",
        "#.......#  #############  #.....#          #.....#",
        "#.......#                  ######         @#.....#",
        "#..######  ###########                @    #.....#",
        "#..#B                #                   @ #.....#",
        "#..#          @  @   #   ###################.....#",
        "#..#                 #   #.......................#",
        "#..#                 #   #.......................#",
        "#..#                     ############............#",
        "#..######  #########               +#............#",
        "#.......#  #.......#~~~             #............#",
        "#.......#  #.......###~~~           #............#",
        "#.......#  #.........#~~~~~         ###########..#",
        "#.......#  #.........##~~~~~                 B#..#",
        "#.......#  ######....##############       #####..#",
        "#.......#      B#.................#       # @ #..#",
        "#.......#   @   ########..........#       H  W#..#",
        "#.......#@             #..........#############..#",
        "#.......#              #.........................#",
        "#########\u2592\u2592##########\u2592\u2592###########################"
    ],
    "inimigos_derrotados": [],
    "baus_abertos": [],
    "interacoes": {},
    "obstaculos": [
        "#",
        "."
    ],
    "cores": null
}