{
    "mapa_id": 2120149246208,
    "mapa_art": [
        "##################################################",
        "#................................................#",
        "#..#########.......################..###########.#",
        "#..#       #.......#           B  #..#B   P   B#.#",
        "#..#       #.......#              #..#         #.#",
        "#..#       #.......#              #..#         #.#",
        "#..#####  ##.......###  ###########..#         #.#",
        "#......#  #..........#  #............#         #.#",
        "#......#  ############  #............#         #.#",
        "#......#               @##############         #.#",
        "#......#                                      @#.#",
        "#......#                ########################.#",
        "#......#    @           #W  @    B#..............#",
        "#..#####                #         #..............#",
        "#..# B                @ #         #..............#",
        "#..#               @    ####HH#####..............#",
        "#..#                              #..............#",
        "#..#     @       @                #..............#",
        "#..#   @                          #..............#",
        "#..#                              #..............#",
        "#..#                       @      #..............#",
        "#..#                             ##..............#",
        "#..################################..............#",
        "#................................................#",
        "##################################################"
    ],
    "inimigos_derrotados": [],
    "inimigos_vivos": [],
    "baus_abertos": [],
    "interacoes": {},
    "obstaculos": [
        "#",
        ".",
        "H"
    ],
    "cores": null
}