{
    "mapa_id": 2149365228608,
    "mapa_art": [
        "##################################################",
        "#................................................#",
        "#..#########.......################..###########.#",
        "#..#       #.......#           B@ #..#B   P @ B#.#",
        "#..#       #.......#              #..# @       #.#",
        "#..#       #.......#              #..# @       #.#",
        "#..#####  ##.......###  ###########..#         #.#",
        "#......#  #..........#  #............#         #.#",
        "#......#  ############  #............#         #.#",
        "#......#                ##############         #.#",
        "#......#                                       #.#",
        "#......#                ########################.#",
        "#......#                #W       B#..............#",
        "#..#####                #         #..............#",
        "#..# B            @     #         #..............#",
        "#..#               @    ####HH#####..............#",
        "#..#                              #..............#",
        "#..#                              #..............#",
        "#..#                   @          #..............#",
        "#..#                     @        #..............#",
        "#..#              @               #..............#",
        "#..#                @            ##..............#",
        "#..################################..............#",
        "#................................................#",
        "##################################################"
    ],
    "inimigos_derrotados": [],
    "baus_abertos": [],
    "interacoes": {},
    "obstaculos": [
        "#",
        ".",
        "H"
    ],
    "cores": null
}